#########################################
#########################################
#########################################
###                                    ##
###                                    ##
###                                    ##
###                                    ##
##########################             ##
#                                      ##
#####    ################################
###                                    ##
##                                     ##
#                .                     ##
#               / \                    ##
#              /   \                   ##
#           ***|   |***                ##
#        ******     ******             ##
#                                      ##
#                                      ##
#                                      ##
#########################################