#########################################
#########################################
#########################################
###                                    ##
###                                    ##
###                                    ##
###                                    ##
##########################             ##
#                                      ##
#####    ################################
###                                    ##
##                                     ##
#                .                     ##
#               / \                    ###################
#              /   \                   ##              ###
#           ***|   |***                	                ##
#        ******  !  ******                              ##
#                                      ##                ##
#                                      ##                 ##
#                                      ##   --------       #
#########################################---  *     -----)####
#######################################(         #        )#### 
#####################################( #    **      *      )### 
######################################( *    *           **  )# #
##############################################################