#########################################
#########################################
#########################################
###                                    ##
###                                    ##
###                                    ##
###                                    ##
##########################             ##
#                                      ## 
#####    ################################
###                                    ##
##                                     ##
#                .                     ##
#               / \                    ## 
#              /   \                   ##  
#          *** |   |***                ##
#       ******      ******             ##
#                                      ##
#                                      ##
#                                      ## 
#########################################